15 15
7,0 7,0 7,0 7,0 7,0 7,0 7,0 7,0 7,0 7,0 7,0 11,0 4,0 4,0 4,0 
7,0 7,0 7,0 7,0 7,0 7,0 7,0 9,270 1,270 5,0 7,0 1,180 4,0 4,0 4,0 
7,0 7,0 7,0 8,0 9,0 7,0 8,0 10,0 9,180 8,180 7,0 10,180 4,0 11,270 1,90 
7,0 7,0 7,0 9,180 8,180 7,0 5,180 5,90 7,0 7,0 7,0 8,270 9,90 7,0 7,0 
7,0 7,0 7,0 7,0 7,0 7,0 7,0 7,0 7,0 7,0 7,0 7,0 7,0 7,0 7,0 
1,270 5,0 7,0 7,0 7,0 7,0 7,0 11,0 1,0 7,0 7,0 5,270 5,0 7,0 7,0 
4,0 1,0 7,0 5,270 5,0 8,0 9,0 1,180 1,0 7,0 7,0 1,180 11,180 7,0 7,0 
4,0 1,0 7,0 5,180 5,90 1,180 1,0 1,180 1,0 7,0 7,0 1,180 4,0 9,0 7,0 
4,0 1,0 7,0 7,0 7,0 1,180 1,0 1,180 1,0 7,0 7,0 1,180 4,0 1,0 7,0 
4,0 1,0 7,0 7,0 7,0 1,180 1,0 1,180 1,0 7,0 7,0 1,180 4,0 1,0 7,0 
4,0 1,0 7,0 7,0 7,0 5,180 5,90 5,180 5,90 7,0 7,0 1,180 4,0 8,180 7,0 
4,0 1,0 7,0 7,0 5,270 1,270 8,90 7,0 7,0 7,0 7,0 1,180 10,0 7,0 7,0 
1,90 5,90 7,0 7,0 9,180 4,0 4,0 10,270 1,270 8,90 7,0 5,180 5,90 7,0 7,0 
7,0 7,0 7,0 7,0 7,0 8,270 1,90 1,90 1,90 9,90 7,0 7,0 7,0 7,0 7,0 
7,0 7,0 7,0 7,0 7,0 7,0 7,0 7,0 7,0 7,0 7,0 7,0 7,0 7,0 7,0 
